9 16
1 5 5 5 7 5 5 5 1 1 1 0 0 0 0 0 
3 0 0 0 3 0 0 0 3 0 3 0 0 0 0 0 
3 5 5 5 3 5 5 5 3 0 3 0 0 0 0 0 
3 0 0 0 3 0 0 0 3 0 3 0 0 0 0 0 
2 5 5 5 2 5 5 5 2 0 2 4 4 4 4 4 
0 0 0 0 0 0 0 0 0 0 0 0 0 0 0 0 
0 0 0 0 0 0 0 0 0 0 0 0 0 0 0 0 
0 0 0 0 0 0 0 0 0 0 0 0 0 0 0 0
0 6 6 6 0 6 6 6 0 0 0 0 0 0 0 0 