11 13
1 5 5 5 7 5 5 5 1 1 4 1 1
3 0 0 0 3 0 0 0 3 0 0 0 3
3 1 4 1 3 5 5 5 3 5 5 5 3
3 0 0 0 3 0 0 0 3 0 0 0 3
3 5 5 5 3 1 4 1 3 5 5 5 3
3 0 0 0 3 0 0 0 3 0 0 0 3
3 5 5 5 3 5 5 5 3 5 5 5 3
0 0 0 0 0 0 0 0 0 0 0 0 0
0 0 0 0 0 0 0 0 0 0 0 0 0
0 0 0 0 0 0 0 0 0 0 0 0 0
0 6 6 6 0 6 6 6 0 6 6 6 0