14 14
0 0 0 0 0 0 0 0 0 0 0 0 0 0 
0 7 1 1 5 5 5 5 5 5 5 1 1 4 
0 0 0 3 0 0 0 0 0 0 0 3 0 0 
0 0 0 3 0 4 4 4 4 4 0 3 0 0 
0 0 0 3 0 0 0 0 0 0 0 3 0 0 
0 0 0 1 5 5 5 5 5 5 5 3 0 0 
0 0 0 0 0 0 0 0 0 0 0 3 0 0 
0 0 0 0 5 5 5 5 5 5 5 3 0 0 
0 0 0 0 0 0 0 0 0 0 0 3 0 0 
0 0 0 1 5 5 5 5 5 5 5 1 0 0 
0 0 0 0 0 0 0 0 0 0 0 0 0 0 
0 0 0 0 0 0 0 0 0 0 0 0 0 0 
0 0 0 0 0 0 0 0 0 0 0 0 0 0 
0 0 0 0 6 6 6 6 6 6 6 0 0 0 
