24 10
1 5 5 5 1 4 4 4 4 0
3 0 0 0 3 0 0 0 0 0
3 5 5 5 3 0 0 0 0 0
3 0 0 0 3 0 0 0 0 0
3 5 5 5 3 0 0 0 0 0
3 0 0 0 3 0 0 0 0 0
3 5 5 5 3 0 0 0 0 0
3 0 0 0 3 0 0 0 0 0
3 5 5 5 3 0 0 0 0 0
3 0 0 0 3 0 0 0 0 0
3 5 5 5 3 0 0 0 0 0
3 0 0 0 3 0 0 0 0 0
3 5 5 5 3 0 0 0 0 0
3 0 0 0 3 0 0 0 0 0
3 5 5 5 3 7 0 0 0 0 
0 0 0 0 0 0 0 0 0 0
0 0 0 0 0 0 0 0 0 0
0 0 0 0 0 0 0 0 0 0
0 0 0 0 0 0 0 0 0 0
0 0 0 0 0 0 0 0 0 0
0 0 0 0 0 0 0 0 0 0
0 0 0 0 0 0 0 0 0 0
0 0 0 0 0 0 0 0 0 0
0 6 6 6 0 0 0 0 0 0

