13 11
1 5 5 5 1 4 0 0 0 0 0
3 0 0 0 3 0 0 0 0 0 0
3 5 5 5 3 0 0 0 0 0 0
3 0 0 0 3 0 0 0 0 0 0
2 5 5 5 2 7 1 5 5 5 1
0 0 0 0 0 0 3 0 0 0 3
0 0 0 0 0 0 3 5 5 5 3
0 0 0 0 0 0 3 0 0 0 3
0 6 6 6 0 4 2 5 5 5 2
0 0 0 0 0 0 0 0 0 0 0
0 0 0 0 0 0 0 0 0 0 0
0 0 0 0 0 0 0 0 0 0 0
0 0 0 0 0 0 0 6 6 6 0