17 16
0 0 0 0 0 0 0 0 0 0 0 0 3 5 5 5 
0 0 0 0 0 5 5 5 0 4 1 1 3 0 0 0 
0 5 5 5 1 3 0 0 0 0 0 0 1 5 5 5
0 3 0 0 0 5 5 5 0 0 0 3 3 0 0 0
0 3 0 1 1 3 0 0 0 0 3 3 3 0 4 4 
0 3 0 3 0 3 3 0 0 3 3 0 3 0 0 0 
0 3 0 3 0 3 3 0 3 3 0 0 3 0 4 4 
0 5 5 5 0 2 2 7 2 2 0 0 3 0 0 0
0 3 0 3 0 3 0 3 0 0 0 0 3 0 4 4
0 3 0 3 0 3 0 3 0 0 0 0 3 0 0 0
0 3 0 3 0 5 5 5 0 0 0 0 3 5 5 5
0 5 5 5 0 0 3 0 0 1 1 1 2 0 0 0
0 0 0 0 0 0 0 0 0 3 0 0 0 0 0 0
0 4 4 4 0 4 4 4 0 2 1 1 1 5 5 5
0 0 0 0 0 0 0 0 0 0 0 0 0 0 0 0
0 6 6 6 0 6 6 6 0 0 0 0 0 6 6 6 
0 0 0 0 0 0 0 0 0 0 0 0 0 0 0 0