9 14
1 1 5 5 5 1 1 1 1 1 5 5 5 4
3 0 0 0 0 0 0 0 0 3 0 0 0 0
3 0 5 5 5 1 7 1 1 2 5 5 5 1
3 0 0 0 0 3 0 3 0 0 0 0 0 3
2 4 5 5 5 2 0 2 1 1 5 5 5 2
0 0 0 0 0 0 0 0 0 0 0 0 0 0
0 0 0 0 0 0 0 0 0 0 0 0 0 0
0 0 0 0 0 0 0 0 0 0 0 0 0 0
0 0 6 6 6 0 0 0 0 0 6 6 6 0